  __  __           _   _                     _____                       _      
 |  \/  |         | | (_)                   / ____|                     | |     
 | \  / |_   _ ___| |_ _  __ _ _   _  ___  | (___   __ _ _ __ ___  _ __ | | ___ 
 | |\/| | | | / __| __| |/ _` | | | |/ _ \  \___ \ / _` | '_ ` _ \| '_ \| |/ _ \
 | |  | | |_| \__ \ |_| | (_| | |_| |  __/  ____) | (_| | | | | | | |_) | |  __/
 |_|  |_|\__, |___/\__|_|\__, |\__,_|\___| |_____/ \__,_|_| |_| |_| .__/|_|\___|
          __/ |             | |                                   | |           
         |___/              |_|                                   |_|           